################
#   X  @       #
#              #
#              #
#              #
#              #
#              #
#              #
#              #
#              #
#              #
#              #
#              #
#s#            #
#s#            #
################
