################
#   X  @       #
#              #
#              #
#              #
#              #
#              #
#              #
#              #
#              #
#              #
##             #
#c#            #
#s#            #
#s#            #
################
