################
#   X  @       #
#              #
#              #
#              #
#              #
#              #
#              #
#              #
#              #
#              #
#              #
#              #
#              #
#d             #
################
