################
#      #G#     #
#              #
#   C       @  #
#       d      #
#     s       V#
###          ###
#L     XX     G#
###    ss    ###
#              #
#              #
#   d     dd   #
#   d  V       #
#C            C#
#CC   #L#    CC#
################
