################
#   X  @       #
#              #
#              #
#              #
#            ###
#            # #
#      ####### #
#      #s   c  #
#      ##      #
#        ##### #
##            ##
#c#            #
#s#            #
#s#            #
################
