################
#   X  @       #
#              #
#              #
#              #
#              #
#              #
#              #
#              #
#              #
###            #
#c#            #
# #            #
#s#            #
#s#            #
################
