################
#   X  @       #
#              #
#              #
#              #
#    d         #
#              #
#              #
#              #
#              #
#              #
#              #
#              #
#              #
#d            d#
################
